2 13 31
###############################
#p     ** *2  1 *   *  * * *  #
#                 # # #*#*#*# #
#  x*     *s*  *      *   * * #
# # # b # #*# f #*#*# # # # #*#
#f         x **  *  *         #
# #                *# #*# # # #
#*  *      h  *      *        #
# # f     s     b  *# # # # # #
#*    **  *       *           #
# #*# # # # # # #*# # # # # # #
#           *   *  *          #
###############################
