2 13 31
###############################
#p     ** *2  1 *   *  * * *  #
#                 # # #*#*#*# #
#  x*     *s*  *      *   * * #
# # # b # #*# f #*#*# # # # #*#
#f   3     x **  *  *         #
# #     3          *# #*# # # #
#*  *      h  *      *        #
# # f    s   3  b  *# # # # # #
#*    ** *  3     *           #
# #*# # # # # # #*# # # # # # #
#           *   *  *          #
###############################
