3 13 31
###############################
#p     ** *  1 *   *  * * *   #
# # # #                       #
#  x*     ***  *      *   * * #
# # # # # #*# # #           #*#
#f         x *                #
# # # #                       #
#*  *      *  *               #
# # # # #*# # # #*#*# # # # # #
#*    **          *           #
# #*# # # # # # #*# # # # # # #
#           *   *  *          #
###############################
